0 0 0 0 0 0 0 0 0 0 3 3 3 3 3 3
0 0 0 0 0 10 10 10 10 10 10 3 3 3 3 3
2 0 0 0 0 10 10 10 10 0 0 0 3 3 3 3
0 0 0 0 0 0 0 0 0 0 0 0 10 10 3 3
0 0 0 0 0 0 0 0 0 0 0 0 10 10 3 3
0 0 0 0 0 0 0 0 0 0 3 3 0 0 0 0
0 0 0 0 0 0 0 0 0 0 3 3 3 0 0 2
0 0 0 0 0 0 3 3 3 3 3 3 3 3 3 3
0 0 3 3 3 3 3 3 3 3 3 3 3 3 3 3
0 0 3 3 3 3 3 3 10 10 10 10 0 0 0 0
0 0 3 3 3 3 0 0 10 10 10 10 10 0 0 0
0 0 0 0 0 0 0 0 0 0 0 0 0 0 0 0