0 0 0 0 0 0 0 0 3 0 0 0 3 0 0 0
3 3 3 0 0 0 3 0 0 0 3 0 0 0 0 2
3 3 3 0 0 3 3 3 3 3 3 3 3 3 3 3
0 10 10 0 0 0 0 3 0 0 0 0 0 3 9 0
0 10 10 0 0 0 0 3 0 0 0 0 0 3 0 0
0 10 10 0 0 0 0 3 0 10 3 0 0 3 10 0
0 0 0 0 0 0 0 3 0 10 3 0 0 3 10 0
0 0 0 0 0 0 0 3 0 10 3 0 0 3 10 0
3 3 3 3 3 0 0 0 0 10 3 0 0 3 10 0
0 0 0 0 0 0 10 0 0 0 3 0 0 3 10 0
0 0 0 0 10 10 0 0 0 10 3 0 0 3 0 0
2 0 0 0 10 10 0 0 0 10 3 0 0 0 0 0