0 0 0 0 0 4 0 0 0 4 0 0 0 0 0 0
0 2 0 0 0 4 0 0 0 4 0 0 0 0 0 0
0 0 0 0 0 4 0 0 0 4 0 0 0 0 0 0
0 0 0 5 0 4 0 0 0 4 0 0 5 5 5 0
0 0 0 0 0 4 0 0 0 4 0 0 0 0 0 0
0 0 0 0 0 4 0 0 0 4 0 0 0 0 0 0
0 0 0 0 0 4 0 0 0 4 0 0 0 0 0 0
0 0 0 0 0 4 0 0 0 4 0 0 0 8 0 0
0 0 0 0 0 4 0 0 0 4 0 0 0 0 0 0
0 0 0 0 0 4 0 0 0 4 0 0 0 0 0 0
0 0 0 0 0 4 0 0 0 4 0 0 0 0 0 0
0 0 0 0 0 4 0 0 0 4 0 0 0 0 0 0